Geography,Geographic Area Name,Estimate!!Total,Margin of Error!!Total,Estimate!!Total!!English only,Margin of Error!!Total!!English only,Estimate!!Total!!Spanish,Margin of Error!!Total!!Spanish,"Estimate!!Total!!Spanish!!No one 14 and over speaks English only or speaks English very well""""","Margin of Error!!Total!!Spanish!!No one 14 and over speaks English only or speaks English very well""""","Estimate!!Total!!Spanish!!At least one person 14 and over speaks English only or speaks English very well""""","Margin of Error!!Total!!Spanish!!At least one person 14 and over speaks English only or speaks English very well""""",Estimate!!Total!!Other Indo-European languages,Margin of Error!!Total!!Other Indo-European languages,"Estimate!!Total!!Other Indo-European languages!!No one 14 and over speaks English only or speaks English very well""""","Margin of Error!!Total!!Other Indo-European languages!!No one 14 and over speaks English only or speaks English very well""""","Estimate!!Total!!Other Indo-European languages!!At least one person 14 and over speaks English only or speaks English very well""""","Margin of Error!!Total!!Other Indo-European languages!!At least one person 14 and over speaks English only or speaks English very well""""",Estimate!!Total!!Asian and Pacific Island languages,Margin of Error!!Total!!Asian and Pacific Island languages,"Estimate!!Total!!Asian and Pacific Island languages!!No one 14 and over speaks English only or speaks English very well""""","Margin of Error!!Total!!Asian and Pacific Island languages!!No one 14 and over speaks English only or speaks English very well""""","Estimate!!Total!!Asian and Pacific Island languages!!At least one person 14 and over speaks English only or speaks English very well""""","Margin of Error!!Total!!Asian and Pacific Island languages!!At least one person 14 and over speaks English only or speaks English very well""""",Estimate!!Total!!Other languages,Margin of Error!!Total!!Other languages,"Estimate!!Total!!Other languages!!No one 14 and over speaks English only or speaks English very well""""","Margin of Error!!Total!!Other languages!!No one 14 and over speaks English only or speaks English very well""""","Estimate!!Total!!Other languages!!At least one person 14 and over speaks English only or speaks English very well""""","Margin of Error!!Total!!Other languages!!At least one person 14 and over speaks English only or speaks English very well"""""
0400000US48,Texas,8782598,17197,5767760,11645,2475172,8876,614497,5940,1860675,9263,235761,3471,25800,1292,209961,3444,239814,2792,64735,1487,175079,2668,64091,1877,9527,774,54564,1752
0500000US48001,"Anderson County, Texas",16245,404,14554,422,1544,222,265,102,1279,213,34,28,0,30,34,28,76,41,3,7,73,42,37,32,0,30,37,32
0500000US48003,"Andrews County, Texas",5183,213,2930,178,2164,190,545,171,1619,199,25,33,0,20,25,33,64,36,19,21,45,33,0,20,0,20,0,20
0500000US48005,"Angelina County, Texas",30846,543,26056,536,4332,346,1100,253,3232,326,331,123,2,4,329,123,105,65,0,30,105,65,22,29,0,30,22,29
0500000US48007,"Aransas County, Texas",9825,471,7956,416,1618,238,224,88,1394,245,62,58,0,24,62,58,149,73,6,13,143,72,40,47,26,41,14,24
0500000US48009,"Archer County, Texas",3330,144,3143,131,164,39,40,23,124,34,12,13,0,18,12,13,11,14,0,18,11,14,0,18,0,18,0,18
0500000US48011,"Armstrong County, Texas",668,61,650,55,7,10,0,13,7,10,0,13,0,13,0,13,11,14,0,13,11,14,0,13,0,13,0,13
0500000US48013,"Atascosa County, Texas",14995,392,7511,391,7379,397,1388,270,5991,426,48,40,12,21,36,34,36,34,18,27,18,27,21,30,0,27,21,30
0500000US48015,"Austin County, Texas",10600,325,8708,315,1563,225,344,147,1219,224,297,80,44,29,253,76,32,29,13,21,19,21,0,24,0,24,0,24
0500000US48017,"Bailey County, Texas",2357,169,1162,171,1195,202,319,144,876,212,0,18,0,18,0,18,0,18,0,18,0,18,0,18,0,18,0,18
0500000US48019,"Bandera County, Texas",8495,328,7277,345,1004,176,32,36,972,170,154,80,3,5,151,81,60,25,8,12,52,30,0,24,0,24,0,24
0500000US48021,"Bastrop County, Texas",25471,548,19401,665,5512,383,1355,351,4157,361,289,109,0,30,289,109,218,93,18,29,200,91,51,57,0,30,51,57
0500000US48023,"Baylor County, Texas",1735,111,1620,118,82,38,13,17,69,31,33,43,0,13,33,43,0,13,0,13,0,13,0,13,0,13,0,13
0500000US48025,"Bee County, Texas",8681,360,4641,321,3923,296,628,160,3295,306,49,48,0,27,49,48,40,38,0,27,40,38,28,51,0,27,28,51
0500000US48027,"Bell County, Texas",103715,996,82400,1031,14284,637,2394,349,11890,667,3524,369,225,90,3299,366,3063,331,463,140,2600,313,444,160,0,30,444,160
0500000US48029,"Bexar County, Texas",596862,2306,300326,2442,268067,2471,38480,1472,229587,2569,13355,823,1248,232,12107,765,12542,612,2612,364,9930,593,2572,339,433,148,2139,338
0500000US48031,"Blanco County, Texas",4104,257,3330,212,682,109,242,90,440,111,80,53,0,20,80,53,7,12,0,20,7,12,5,15,5,15,0,20
0500000US48033,"Borden County, Texas",239,40,216,37,20,16,0,13,20,16,3,4,0,13,3,4,0,13,0,13,0,13,0,13,0,13,0,13
0500000US48035,"Bosque County, Texas",6883,228,6120,214,720,98,199,80,521,94,30,18,0,20,30,18,10,10,0,20,10,10,3,4,0,20,3,4
0500000US48037,"Bowie County, Texas",33920,578,31518,555,1655,242,308,143,1347,254,417,168,4,6,413,169,273,103,57,32,216,100,57,56,13,22,44,52
0500000US48039,"Brazoria County, Texas",105920,1003,77228,1213,21137,805,3024,391,18113,801,3034,497,216,120,2818,466,3940,358,781,220,3159,342,581,250,45,66,536,255
0500000US48041,"Brazos County, Texas",68936,805,51982,845,10875,545,2960,413,7915,574,2841,343,530,156,2311,324,2862,294,988,220,1874,279,376,142,30,34,346,140
0500000US48043,"Brewster County, Texas",4106,226,2341,189,1703,209,145,67,1558,201,40,32,4,7,36,32,22,26,0,18,22,26,0,18,0,18,0,18
0500000US48045,"Briscoe County, Texas",657,64,544,61,113,29,33,17,80,28,0,13,0,13,0,13,0,13,0,13,0,13,0,13,0,13,0,13
0500000US48047,"Brooks County, Texas",2465,194,301,127,2140,198,471,159,1669,161,0,18,0,18,0,18,24,34,17,30,7,12,0,18,0,18,0,18
0500000US48049,"Brown County, Texas",13302,444,12040,415,1144,162,169,80,975,138,47,34,11,18,36,29,71,55,45,45,26,27,0,27,0,27,0,27
0500000US48051,"Burleson County, Texas",6293,278,5531,262,591,138,124,80,467,132,146,82,43,62,103,56,25,23,0,20,25,23,0,20,0,20,0,20
0500000US48053,"Burnet County, Texas",16648,473,14437,381,1943,254,501,192,1442,227,164,80,24,41,140,73,81,74,64,60,17,32,23,24,0,27,23,24
0500000US48055,"Caldwell County, Texas",11640,406,7448,406,4144,341,436,117,3708,323,33,33,0,27,33,33,15,17,0,27,15,17,0,27,0,27,0,27
0500000US48057,"Calhoun County, Texas",7827,350,5492,318,2056,228,444,113,1612,207,65,40,0,24,65,40,206,74,108,48,98,69,8,12,0,24,8,12
0500000US48059,"Callahan County, Texas",5182,212,4826,223,300,96,23,21,277,93,25,20,0,20,25,20,8,8,0,20,8,8,23,32,0,20,23,32
0500000US48061,"Cameron County, Texas",116839,940,28255,871,86987,1092,20973,875,66014,1171,603,140,69,40,534,128,787,114,143,60,644,124,207,105,12,18,195,101
0500000US48063,"Camp County, Texas",4350,216,3713,205,577,96,220,84,357,104,24,27,16,24,8,13,6,9,0,20,6,9,30,35,22,33,8,12
0500000US48065,"Carson County, Texas",2337,107,2142,108,176,65,14,20,162,64,13,21,0,18,13,21,6,8,0,18,6,8,0,18,0,18,0,18
0500000US48067,"Cass County, Texas",11739,334,11244,354,350,87,61,40,289,85,78,86,0,27,78,86,53,40,13,14,40,37,14,23,0,27,14,23
0500000US48069,"Castro County, Texas",2597,155,1327,119,1252,125,376,106,876,134,6,10,0,18,6,10,12,16,0,18,12,16,0,18,0,18,0,18
0500000US48071,"Chambers County, Texas",11822,304,9387,345,1965,227,375,161,1590,280,348,176,7,12,341,176,110,65,33,42,77,65,12,19,0,27,12,19
0500000US48073,"Cherokee County, Texas",17273,421,15044,427,2081,207,630,144,1451,212,66,42,7,15,59,43,53,33,12,21,41,27,29,44,0,30,29,44
0500000US48075,"Childress County, Texas",2431,198,2115,224,260,117,14,26,246,122,44,54,34,51,10,16,12,22,0,18,12,22,0,18,0,18,0,18
0500000US48077,"Clay County, Texas",4272,131,4142,135,105,35,16,16,89,35,23,20,0,20,23,20,2,3,0,20,2,3,0,20,0,20,0,20
0500000US48079,"Cochran County, Texas",1069,64,574,51,481,52,127,44,354,56,13,17,0,13,13,17,1,2,0,13,1,2,0,13,0,13,0,13
0500000US48081,"Coke County, Texas",1411,109,1208,110,199,42,10,11,189,41,4,6,0,13,4,6,0,13,0,13,0,13,0,13,0,13,0,13
0500000US48083,"Coleman County, Texas",3511,192,3272,207,210,67,49,36,161,63,26,30,0,18,26,30,3,5,0,18,3,5,0,18,0,18,0,18
0500000US48085,"Collin County, Texas",283025,1303,206222,1802,32604,1034,6948,628,25656,974,18076,912,2732,433,15344,875,20923,755,5216,507,15707,744,5200,538,440,155,4760,510
0500000US48087,"Collingsworth County, Texas",1197,74,918,79,257,56,56,42,201,58,15,16,8,14,7,10,0,13,0,13,0,13,7,11,0,13,7,11
0500000US48089,"Colorado County, Texas",8048,296,6445,266,1345,152,219,95,1126,160,228,86,22,35,206,81,30,19,18,23,12,18,0,24,0,24,0,24
0500000US48091,"Comal County, Texas",41112,569,32100,688,7189,405,897,215,6292,404,1512,301,43,35,1469,294,280,99,57,50,223,99,31,31,13,21,18,23
0500000US48093,"Comanche County, Texas",5296,241,4424,224,828,103,156,65,672,100,37,27,5,9,32,26,7,9,0,20,7,9,0,20,0,20,0,20
0500000US48095,"Concho County, Texas",918,100,723,88,189,60,51,33,138,52,6,6,3,5,3,5,0,13,0,13,0,13,0,13,0,13,0,13
0500000US48097,"Cooke County, Texas",14489,325,12637,308,1641,175,471,137,1170,172,83,39,0,27,83,39,100,53,34,42,66,39,28,40,0,27,28,40
0500000US48099,"Coryell County, Texas",20464,623,16595,619,2318,270,219,122,2099,251,1046,187,37,36,1009,187,452,137,56,42,396,127,53,50,9,18,44,45
0500000US48101,"Cottle County, Texas",719,198,615,165,102,59,12,10,90,54,2,3,0,13,2,3,0,13,0,13,0,13,0,13,0,13,0,13
0500000US48103,"Crane County, Texas",1551,72,824,59,727,68,176,65,551,81,0,13,0,13,0,13,0,13,0,13,0,13,0,13,0,13,0,13
0500000US48105,"Crockett County, Texas",1273,157,675,136,594,113,149,56,445,113,4,7,0,13,4,7,0,13,0,13,0,13,0,13,0,13,0,13
0500000US48107,"Crosby County, Texas",2195,110,1344,88,843,76,170,48,673,74,8,9,0,18,8,9,0,18,0,18,0,18,0,18,0,18,0,18
0500000US48109,"Culberson County, Texas",854,134,228,81,607,116,104,57,503,102,15,23,0,13,15,23,0,13,0,13,0,13,4,7,0,13,4,7
0500000US48111,"Dallam County, Texas",2339,145,1662,135,605,145,190,102,415,124,62,53,23,27,39,39,10,13,3,3,7,13,0,18,0,18,0,18
0500000US48113,"Dallas County, Texas",849874,2374,548649,2542,236161,1936,75843,1585,160318,2155,24413,1066,3462,434,20951,987,29581,933,8885,603,20696,932,11070,855,2074,382,8996,709
0500000US48115,"Dawson County, Texas",4382,229,2565,205,1725,161,445,117,1280,153,92,54,6,7,86,54,0,20,0,20,0,20,0,20,0,20,0,20
0500000US48117,"Deaf Smith County, Texas",6268,172,2820,178,3338,192,889,161,2449,238,30,26,9,14,21,22,27,22,0,20,27,22,53,61,43,59,10,15
0500000US48119,"Delta County, Texas",1955,123,1891,120,55,36,33,30,22,20,6,11,0,18,6,11,0,18,0,18,0,18,3,5,0,18,3,5
0500000US48121,"Denton County, Texas",237732,1216,184126,1347,31992,799,7771,617,24221,895,9332,764,784,190,8548,738,10398,548,2552,441,7846,514,1884,279,60,40,1824,281
0500000US48123,"DeWitt County, Texas",6890,244,5297,210,1401,173,225,88,1176,159,164,59,4,6,160,61,15,18,0,24,15,18,13,24,0,24,13,24
0500000US48125,"Dickens County, Texas",875,76,768,74,107,33,23,13,84,29,0,13,0,13,0,13,0,13,0,13,0,13,0,13,0,13,0,13
0500000US48127,"Dimmit County, Texas",3428,186,403,150,2986,226,920,171,2066,242,0,20,0,20,0,20,0,20,0,20,0,20,39,55,0,20,39,55
0500000US48129,"Donley County, Texas",1348,107,1254,108,65,25,8,8,57,25,26,21,0,13,26,21,3,4,1,3,2,4,0,13,0,13,0,13
0500000US48131,"Duval County, Texas",3843,232,583,152,3254,244,709,161,2545,246,0,20,0,20,0,20,6,11,0,20,6,11,0,20,0,20,0,20
0500000US48133,"Eastland County, Texas",7145,282,6599,275,511,110,98,80,413,93,24,22,0,20,24,22,11,20,0,20,11,20,0,20,0,20,0,20
0500000US48135,"Ector County, Texas",49065,550,27318,651,20780,499,3315,423,17465,607,497,174,40,48,457,169,351,102,50,38,301,111,119,82,26,31,93,74
0500000US48137,"Edwards County, Texas",854,91,443,78,411,69,74,38,337,69,0,13,0,13,0,13,0,13,0,13,0,13,0,13,0,13,0,13
0500000US48139,"Ellis County, Texas",50327,540,40248,585,8993,417,2035,342,6958,421,613,123,38,32,575,122,349,86,30,38,319,86,124,57,8,15,116,54
0500000US48141,"El Paso County, Texas",252426,1315,53341,1268,191191,1519,49912,1547,141279,1909,4353,502,611,232,3742,474,2941,289,790,208,2151,255,600,157,64,71,536,149
0500000US48143,"Erath County, Texas",14223,346,11638,373,2341,199,408,146,1933,210,119,63,0,27,119,63,125,59,22,22,103,64,0,27,0,27,0,27
0500000US48145,"Falls County, Texas",5738,264,4912,242,710,83,190,64,520,87,81,48,2,4,79,48,35,37,24,32,11,17,0,20,0,20,0,20
0500000US48147,"Fannin County, Texas",11783,292,10905,294,721,143,164,90,557,125,97,50,0,27,97,50,60,35,3,5,57,36,0,27,0,27,0,27
0500000US48149,"Fayette County, Texas",10470,308,8449,273,1461,187,459,144,1002,184,560,119,41,30,519,112,0,24,0,24,0,24,0,24,0,24,0,24
0500000US48151,"Fisher County, Texas",1484,125,1121,115,348,58,35,19,313,57,15,12,0,13,15,12,0,13,0,13,0,13,0,13,0,13,0,13
0500000US48153,"Floyd County, Texas",2598,115,1394,91,1195,105,248,75,947,110,9,15,0,18,9,15,0,18,0,18,0,18,0,18,0,18,0,18
0500000US48155,"Foard County, Texas",535,78,468,76,54,34,9,11,45,33,10,15,0,13,10,15,3,5,0,13,3,5,0,13,0,13,0,13
0500000US48157,"Fort Bend County, Texas",184182,963,110835,1273,36350,908,6141,599,30209,968,13876,849,1340,286,12536,854,18677,754,4136,466,14541,799,4444,553,446,189,3998,545
0500000US48159,"Franklin County, Texas",4207,279,3706,239,460,120,125,82,335,110,16,28,0,20,16,28,25,39,25,39,0,20,0,20,0,20,0,20
0500000US48161,"Freestone County, Texas",7028,336,6366,293,579,141,180,98,399,146,64,49,18,28,46,42,12,20,12,20,0,20,7,12,7,12,0,20
0500000US48163,"Frio County, Texas",4831,242,1499,241,3316,278,553,155,2763,267,16,17,6,10,10,15,0,20,0,20,0,20,0,20,0,20,0,20
0500000US48165,"Gaines County, Texas",5402,206,2757,240,1401,159,393,126,1008,134,1171,219,375,164,796,212,73,65,29,54,44,49,0,20,0,20,0,20
0500000US48167,"Galveston County, Texas",109142,999,86817,1128,16650,665,2951,388,13699,666,3020,359,195,99,2825,342,2276,304,608,154,1668,292,379,132,15,17,364,131
0500000US48169,"Garza County, Texas",1659,453,1184,283,469,222,153,98,316,170,6,9,0,18,6,9,0,18,0,18,0,18,0,18,0,18,0,18
0500000US48171,"Gillespie County, Texas",10694,321,7988,343,1498,195,353,138,1145,198,1167,196,80,50,1087,185,27,38,0,24,27,38,14,21,0,24,14,21
0500000US48173,"Glasscock County, Texas",431,49,338,50,93,46,33,28,60,39,0,13,0,13,0,13,0,13,0,13,0,13,0,13,0,13,0,13
0500000US48175,"Goliad County, Texas",3056,162,2272,163,714,91,114,49,600,95,68,46,0,18,68,46,2,4,0,18,2,4,0,18,0,18,0,18
0500000US48177,"Gonzales County, Texas",6804,226,3888,192,2719,221,500,104,2219,217,182,74,12,16,170,73,12,16,0,24,12,16,3,5,0,24,3,5
0500000US48179,"Gray County, Texas",8465,237,6961,226,1362,148,321,119,1041,166,69,48,0,24,69,48,73,30,23,21,50,36,0,24,0,24,0,24
0500000US48181,"Grayson County, Texas",46600,636,42079,665,3407,243,882,187,2525,268,813,183,57,55,756,171,170,72,39,32,131,64,131,83,0,30,131,83
0500000US48183,"Gregg County, Texas",45083,577,38960,635,5181,336,1460,233,3721,359,446,145,61,60,385,136,412,108,28,26,384,105,84,56,8,12,76,56
0500000US48185,"Grimes County, Texas",8716,295,7321,279,1181,144,346,115,835,138,147,82,10,16,137,82,41,55,21,41,20,33,26,36,0,24,26,36
0500000US48187,"Guadalupe County, Texas",45411,513,30903,605,12462,534,1657,305,10805,538,1349,203,42,38,1307,199,639,112,71,48,568,113,58,41,0,30,58,41
0500000US48189,"Hale County, Texas",11709,372,6432,319,5184,266,869,175,4315,273,53,43,3,5,50,42,40,27,10,15,30,23,0,27,0,27,0,27
0500000US48191,"Hall County, Texas",1270,101,1024,82,214,58,58,26,156,56,24,23,0,13,24,23,3,6,0,13,3,6,5,9,0,13,5,9
0500000US48193,"Hamilton County, Texas",3081,180,2819,176,248,79,62,38,186,71,11,18,11,18,0,18,3,4,3,4,0,18,0,18,0,18,0,18
0500000US48195,"Hansford County, Texas",1918,99,1258,86,643,76,159,59,484,75,10,11,0,18,10,11,7,6,2,3,5,6,0,18,0,18,0,18
0500000US48197,"Hardeman County, Texas",1740,140,1477,157,242,81,61,40,181,72,0,13,0,13,0,13,21,30,0,13,21,30,0,13,0,13,0,13
0500000US48199,"Hardin County, Texas",20468,338,19507,344,737,138,85,59,652,138,131,66,14,18,117,66,82,25,46,20,36,28,11,18,0,30,11,18
0500000US48201,"Harris County, Texas",1412895,3943,845882,3632,433585,2823,142900,2501,290685,3502,52871,1745,6430,448,46441,1693,63063,1348,20524,925,42539,1418,17494,1118,3014,464,14480,1016
0500000US48203,"Harrison County, Texas",23147,499,21113,535,1652,188,485,155,1167,215,257,109,10,16,247,106,88,67,28,52,60,45,37,38,0,30,37,38
0500000US48205,"Hartley County, Texas",1717,118,1436,116,264,103,100,67,164,74,17,20,0,18,17,20,0,18,0,18,0,18,0,18,0,18,0,18
0500000US48207,"Haskell County, Texas",2480,182,2057,132,410,130,89,45,321,124,13,11,0,18,13,11,0,18,0,18,0,18,0,18,0,18,0,18
0500000US48209,"Hays County, Texas",54543,669,38447,787,13734,572,1577,286,12157,574,1537,314,28,26,1509,315,678,199,86,65,592,184,147,107,0,30,147,107
0500000US48211,"Hemphill County, Texas",1405,90,1116,110,284,76,118,67,166,56,5,7,0,13,5,7,0,13,0,13,0,13,0,13,0,13,0,13
0500000US48213,"Henderson County, Texas",30311,573,27647,585,2361,198,314,120,2047,222,236,86,26,28,210,82,62,35,15,17,47,35,5,8,0,30,5,8
0500000US48215,"Hidalgo County, Texas",214396,1244,28217,949,182663,1461,44310,1216,138353,1725,1283,246,265,141,1018,231,1870,173,401,129,1469,179,363,168,0,30,363,168
0500000US48217,"Hill County, Texas",13503,356,11566,336,1653,155,454,104,1199,165,207,73,0,27,207,73,60,24,16,27,44,25,17,20,0,27,17,20
0500000US48219,"Hockley County, Texas",7978,214,5021,203,2878,198,347,138,2531,205,35,29,0,24,35,29,33,18,12,17,21,10,11,17,11,17,0,24
0500000US48221,"Hood County, Texas",20631,481,18675,492,1609,197,239,109,1370,183,205,97,0,30,205,97,142,80,17,26,125,80,0,30,0,30,0,30
0500000US48223,"Hopkins County, Texas",13262,250,11808,261,1306,118,404,131,902,130,82,39,10,17,72,33,50,21,10,14,40,20,16,25,0,27,16,25
0500000US48225,"Houston County, Texas",7883,292,7265,293,485,101,104,54,381,104,90,53,0,24,90,53,43,37,22,28,21,27,0,24,0,24,0,24
0500000US48227,"Howard County, Texas",11079,329,8634,318,2278,238,308,123,1970,223,91,61,0,27,91,61,67,26,16,21,51,31,9,17,0,27,9,17
0500000US48229,"Hudspeth County, Texas",1097,80,170,46,906,77,241,65,665,89,21,17,0,13,21,17,0,13,0,13,0,13,0,13,0,13,0,13
0500000US48231,"Hunt County, Texas",30682,537,27271,567,2917,285,511,159,2406,254,308,131,4,7,304,131,116,66,26,37,90,53,70,53,11,20,59,52
0500000US48233,"Hutchinson County, Texas",8318,289,7005,282,1221,163,205,69,1016,167,32,22,0,24,32,22,60,29,6,8,54,29,0,24,0,24,0,24
0500000US48235,"Irion County, Texas",587,54,459,54,124,31,26,18,98,37,0,13,0,13,0,13,4,9,0,13,4,9,0,13,0,13,0,13
0500000US48237,"Jack County, Texas",3010,155,2736,150,240,70,38,34,202,77,26,20,0,18,26,20,8,14,8,14,0,18,0,18,0,18,0,18
0500000US48239,"Jackson County, Texas",5191,209,3934,203,1085,111,175,69,910,130,168,81,0,20,168,81,4,12,4,12,0,20,0,20,0,20,0,20
0500000US48241,"Jasper County, Texas",13722,315,12828,332,633,110,196,75,437,119,194,102,19,24,175,99,51,40,26,32,25,37,16,19,0,27,16,19
0500000US48243,"Jeff Davis County, Texas",879,118,469,120,402,80,18,14,384,81,8,11,0,13,8,11,0,13,0,13,0,13,0,13,0,13,0,13
0500000US48245,"Jefferson County, Texas",92754,892,76578,884,11108,532,3559,487,7549,485,2660,339,273,120,2387,333,2133,253,457,161,1676,242,275,115,19,23,256,111
0500000US48247,"Jim Hogg County, Texas",1784,166,126,65,1640,177,294,106,1346,162,0,18,0,18,0,18,0,18,0,18,0,18,18,22,0,18,18,22
0500000US48249,"Jim Wells County, Texas",13515,357,4320,391,9091,408,1229,194,7862,436,72,47,0,27,72,47,19,32,19,32,0,27,13,21,0,27,13,21
0500000US48251,"Johnson County, Texas",51776,603,44536,648,6372,399,1277,251,5095,424,418,124,4,6,414,123,346,88,122,68,224,64,104,68,0,30,104,68
0500000US48253,"Jones County, Texas",5566,606,4555,524,960,181,119,64,841,164,23,21,5,8,18,20,23,26,0,20,23,26,5,9,0,20,5,9
0500000US48255,"Karnes County, Texas",4496,292,2443,191,1916,226,288,100,1628,197,137,39,15,14,122,37,0,20,0,20,0,20,0,20,0,20,0,20
0500000US48257,"Kaufman County, Texas",34597,447,29561,457,4385,318,1121,216,3264,326,368,152,7,13,361,152,224,108,48,53,176,92,59,48,0,30,59,48
0500000US48259,"Kendall County, Texas",12742,290,10229,402,2042,300,365,132,1677,286,378,130,0,27,378,130,93,76,36,61,57,44,0,27,0,27,0,27
0500000US48261,"Kenedy County, Texas",168,70,113,50,55,39,15,22,40,31,0,13,0,13,0,13,0,13,0,13,0,13,0,13,0,13,0,13
0500000US48263,"Kent County, Texas",394,64,365,62,29,29,11,15,18,27,0,13,0,13,0,13,0,13,0,13,0,13,0,13,0,13,0,13
0500000US48265,"Kerr County, Texas",20376,411,16458,349,3492,264,581,172,2911,275,313,121,74,64,239,110,108,59,10,20,98,63,5,7,0,27,5,7
0500000US48267,"Kimble County, Texas",1950,155,1537,135,411,90,74,47,337,83,2,3,2,3,0,13,0,13,0,13,0,13,0,13,0,13,0,13
0500000US48269,"King County, Texas",103,27,95,26,4,6,0,13,4,6,4,6,4,6,0,13,0,13,0,13,0,13,0,13,0,13,0,13
0500000US48271,"Kinney County, Texas",1185,114,543,121,532,110,71,43,461,104,58,60,0,13,58,60,52,63,12,19,40,59,0,13,0,13,0,13
0500000US48273,"Kleberg County, Texas",11024,348,4451,357,6182,320,933,212,5249,346,227,125,23,35,204,119,155,65,47,38,108,62,9,14,0,27,9,14
0500000US48275,"Knox County, Texas",1598,76,1199,63,385,56,93,32,292,56,14,13,4,6,10,11,0,13,0,13,0,13,0,13,0,13,0,13
0500000US48277,"Lamar County, Texas",19260,374,17999,384,818,123,122,68,696,144,308,110,64,47,244,101,119,37,41,25,78,45,16,18,0,27,16,18
0500000US48279,"Lamb County, Texas",4890,187,2891,171,1990,152,479,104,1511,139,5,6,0,20,5,6,4,6,0,20,4,6,0,20,0,20,0,20
0500000US48281,"Lampasas County, Texas",7091,255,5935,277,840,146,110,64,730,146,218,70,10,15,208,71,80,43,12,19,68,48,18,20,12,18,6,10
0500000US48283,"La Salle County, Texas",1884,186,569,153,1304,162,308,111,996,139,0,18,0,18,0,18,11,18,0,18,11,18,0,18,0,18,0,18
0500000US48285,"Lavaca County, Texas",7879,242,6113,267,1133,153,257,102,876,151,616,117,31,21,585,119,17,14,5,10,12,12,0,20,0,20,0,20
0500000US48287,"Lee County, Texas",6026,253,4798,247,883,138,181,103,702,120,282,85,32,25,250,77,38,32,0,20,38,32,25,17,0,20,25,17
0500000US48289,"Leon County, Texas",6434,274,5961,281,451,94,152,70,299,79,22,28,2,7,20,27,0,20,0,20,0,20,0,20,0,20,0,20
0500000US48291,"Liberty County, Texas",24461,701,20681,590,3188,386,616,197,2572,340,508,188,69,53,439,175,69,56,0,30,69,56,15,27,0,30,15,27
0500000US48293,"Limestone County, Texas",7928,476,7016,361,814,213,381,118,433,148,70,37,14,17,56,32,22,14,15,11,7,12,6,10,0,24,6,10
0500000US48295,"Lipscomb County, Texas",1129,84,889,81,227,44,65,30,162,39,10,12,0,13,10,12,1,2,0,13,1,2,2,3,0,13,2,3
0500000US48297,"Live Oak County, Texas",3829,232,2620,201,1152,139,171,65,981,137,41,32,0,20,41,32,16,21,0,20,16,21,0,20,0,20,0,20
0500000US48299,"Llano County, Texas",8536,946,8031,885,450,111,101,69,349,120,41,29,3,4,38,28,14,27,0,20,14,27,0,20,0,20,0,20
0500000US48301,"Loving County, Texas",35,15,35,15,0,13,0,13,0,13,0,13,0,13,0,13,0,13,0,13,0,13,0,13,0,13,0,13
0500000US48303,"Lubbock County, Texas",104791,864,77410,1090,23852,751,2561,367,21291,761,1649,243,99,70,1550,227,1372,204,419,141,953,181,508,249,53,46,455,240
0500000US48305,"Lynn County, Texas",2173,108,1310,104,817,71,186,50,631,76,45,24,32,24,13,9,0,18,0,18,0,18,1,2,0,18,1,2
0500000US48307,"McCulloch County, Texas",3053,174,2336,170,678,99,69,50,609,98,9,15,0,18,9,15,30,32,0,18,30,32,0,18,0,18,0,18
0500000US48309,"McLennan County, Texas",83966,794,67569,872,13673,528,3726,390,9947,510,1649,277,84,56,1565,275,856,137,318,107,538,129,219,104,43,48,176,93
0500000US48311,"McMullen County, Texas",289,54,159,51,130,44,16,14,114,43,0,13,0,13,0,13,0,13,0,13,0,13,0,13,0,13,0,13
0500000US48313,"Madison County, Texas",3588,541,3257,282,291,313,49,118,242,207,22,28,0,20,22,28,14,20,0,20,14,20,4,7,0,20,4,7
0500000US48315,"Marion County, Texas",4620,204,4382,183,202,80,6,12,196,79,23,21,0,20,23,21,8,8,6,8,2,4,5,8,0,20,5,8
0500000US48317,"Martin County, Texas",1531,106,1092,101,411,80,94,36,317,79,26,14,12,10,14,10,0,18,0,18,0,18,2,3,0,18,2,3
0500000US48319,"Mason County, Texas",1690,121,1364,117,265,82,117,56,148,55,61,40,0,13,61,40,0,13,0,13,0,13,0,13,0,13,0,13
0500000US48321,"Matagorda County, Texas",13338,447,9316,409,3654,349,673,203,2981,367,173,91,34,29,139,87,183,64,68,57,115,66,12,14,0,27,12,14
0500000US48323,"Maverick County, Texas",15448,305,552,138,14708,305,5469,447,9239,454,43,32,8,13,35,35,30,44,30,44,0,30,115,66,59,55,56,52
0500000US48325,"Medina County, Texas",15413,363,8687,338,6435,406,988,210,5447,398,241,129,0,27,241,129,50,53,0,27,50,53,0,27,0,27,0,27
0500000US48327,"Menard County, Texas",869,96,630,100,225,61,48,34,177,51,14,24,0,13,14,24,0,13,0,13,0,13,0,13,0,13,0,13
0500000US48329,"Midland County, Texas",49898,507,33420,502,15061,479,2864,350,12197,548,839,211,33,34,806,207,388,89,146,65,242,87,190,97,0,30,190,97
0500000US48331,"Milam County, Texas",9398,319,7820,312,1366,161,334,110,1032,149,181,71,0,24,181,71,31,50,0,24,31,50,0,24,0,24,0,24
0500000US48333,"Mills County, Texas",1855,116,1636,112,201,58,35,34,166,49,14,15,0,13,14,15,0,13,0,13,0,13,4,7,0,13,4,7
0500000US48335,"Mitchell County, Texas",2747,222,1859,186,865,212,124,55,741,199,23,39,0,18,23,39,0,18,0,18,0,18,0,18,0,18,0,18
0500000US48337,"Montague County, Texas",8058,287,7284,292,673,128,57,40,616,125,68,38,0,20,68,38,17,26,0,20,17,26,16,24,0,20,16,24
0500000US48339,"Montgomery County, Texas",160190,1308,130194,1414,23152,689,6060,539,17092,769,3589,460,183,61,3406,466,2599,342,573,168,2026,302,656,194,46,52,610,179
0500000US48341,"Moore County, Texas",6799,235,3522,175,2868,205,823,175,2045,220,138,65,0,24,138,65,207,81,166,83,41,31,64,34,32,29,32,28
0500000US48343,"Morris County, Texas",5028,214,4753,208,249,57,79,38,170,67,9,8,0,20,9,8,6,10,6,10,0,20,11,21,0,20,11,21
0500000US48345,"Motley County, Texas",457,53,411,48,45,23,0,13,45,23,0,13,0,13,0,13,1,2,0,13,1,2,0,13,0,13,0,13
0500000US48347,"Nacogdoches County, Texas",23247,474,20182,478,2591,249,728,157,1863,249,174,80,24,26,150,75,223,59,58,58,165,62,77,58,43,48,34,30
0500000US48349,"Navarro County, Texas",17441,358,14276,354,2894,172,1077,189,1817,221,139,73,4,7,135,75,132,54,18,25,114,63,0,27,0,27,0,27
0500000US48351,"Newton County, Texas",5185,240,4971,246,92,83,10,12,82,82,72,45,9,14,63,43,43,42,5,8,38,43,7,13,0,20,7,13
0500000US48353,"Nolan County, Texas",5709,248,4249,219,1421,160,188,77,1233,149,25,21,0,20,25,21,7,13,0,20,7,13,7,13,0,20,7,13
0500000US48355,"Nueces County, Texas",122305,1092,60961,1124,56719,1186,8533,638,48186,1263,2291,381,163,77,2128,356,2029,238,359,130,1670,255,305,116,0,30,305,116
0500000US48357,"Ochiltree County, Texas",3732,117,2229,142,1478,131,513,128,965,143,12,21,0,20,12,21,13,12,4,6,9,10,0,20,0,20,0,20
0500000US48359,"Oldham County, Texas",727,84,665,76,52,28,7,9,45,26,10,7,0,13,10,7,0,13,0,13,0,13,0,13,0,13,0,13
0500000US48361,"Orange County, Texas",31105,499,28429,557,1679,278,246,163,1433,279,662,159,54,42,608,148,302,76,103,66,199,77,33,39,0,30,33,39
0500000US48363,"Palo Pinto County, Texas",10556,305,9124,336,1202,151,341,79,861,155,191,102,8,13,183,101,29,27,19,21,10,15,10,13,0,24,10,13
0500000US48365,"Panola County, Texas",8870,318,8381,313,438,116,114,68,324,108,18,22,0,24,18,22,33,43,0,24,33,43,0,24,0,24,0,24
0500000US48367,"Parker County, Texas",41640,535,37373,593,3483,319,549,168,2934,295,433,133,0,30,433,133,187,70,25,23,162,70,164,69,0,30,164,69
0500000US48369,"Parmer County, Texas",3299,108,1721,113,1553,112,439,94,1114,127,22,16,0,20,22,16,3,5,0,20,3,5,0,20,0,20,0,20
0500000US48371,"Pecos County, Texas",4745,184,1750,198,2957,197,616,126,2341,222,38,48,38,48,0,20,0,20,0,20,0,20,0,20,0,20,0,20
0500000US48373,"Polk County, Texas",17038,587,15108,505,1464,340,331,126,1133,305,264,123,0,27,264,123,63,54,24,31,39,46,139,50,14,13,125,50
0500000US48375,"Potter County, Texas",42430,513,30468,553,10091,451,2293,339,7798,410,420,110,38,33,382,110,1104,150,484,104,620,141,347,140,169,100,178,92
0500000US48377,"Presidio County, Texas",2654,198,493,113,2107,201,786,156,1321,194,54,53,0,18,54,53,0,18,0,18,0,18,0,18,0,18,0,18
0500000US48379,"Rains County, Texas",4256,231,3986,233,240,78,25,38,215,78,16,15,5,6,11,13,10,9,0,20,10,9,4,6,0,20,4,6
0500000US48381,"Randall County, Texas",47312,605,41162,617,4699,384,470,144,4229,383,648,146,105,77,543,144,585,103,228,77,357,102,218,96,19,21,199,90
0500000US48383,"Reagan County, Texas",1172,75,581,83,586,70,163,57,423,78,0,13,0,13,0,13,0,13,0,13,0,13,5,8,0,13,5,8
0500000US48385,"Real County, Texas",1218,129,983,127,229,66,33,28,196,53,0,13,0,13,0,13,6,9,6,9,0,13,0,13,0,13,0,13
0500000US48387,"Red River County, Texas",4945,228,4649,242,226,102,119,113,107,40,56,50,3,6,53,50,5,9,0,20,5,9,9,10,0,20,9,10
0500000US48389,"Reeves County, Texas",3474,201,1146,134,2313,171,517,91,1796,158,15,20,0,20,15,20,0,20,0,20,0,20,0,20,0,20,0,20
0500000US48391,"Refugio County, Texas",2784,141,1775,143,946,99,122,50,824,100,27,20,8,10,19,20,33,36,0,18,33,36,3,4,0,18,3,4
0500000US48393,"Roberts County, Texas",347,37,311,39,15,14,0,13,15,14,9,10,0,13,9,10,12,14,0,13,12,14,0,13,0,13,0,13
0500000US48395,"Robertson County, Texas",5989,282,5109,262,765,145,107,81,658,134,80,49,0,20,80,49,22,13,1,2,21,13,13,18,0,20,13,18
0500000US48397,"Rockwall County, Texas",26141,427,21613,504,3095,315,444,195,2651,303,698,215,47,41,651,216,474,106,106,77,368,115,261,113,0,30,261,113
0500000US48399,"Runnels County, Texas",3976,193,3317,194,621,105,144,50,477,103,27,22,10,16,17,16,11,14,6,11,5,9,0,20,0,20,0,20
0500000US48401,"Rusk County, Texas",18060,373,16206,364,1677,153,377,142,1300,186,92,54,0,30,92,54,76,26,17,23,59,27,9,15,0,30,9,15
0500000US48403,"Sabine County, Texas",4269,249,3984,227,270,86,41,22,229,87,15,27,0,20,15,27,0,20,0,20,0,20,0,20,0,20,0,20
0500000US48405,"San Augustine County, Texas",3368,211,3197,215,87,51,28,29,59,43,84,77,18,26,66,71,0,18,0,18,0,18,0,18,0,18,0,18
0500000US48407,"San Jacinto County, Texas",9238,421,8550,400,633,167,147,112,486,132,40,25,0,24,40,25,15,17,2,6,13,16,0,24,0,24,0,24
0500000US48409,"San Patricio County, Texas",22235,470,12036,425,9880,406,1652,279,8228,450,219,74,20,22,199,71,85,49,3,6,82,48,15,18,0,30,15,18
0500000US48411,"San Saba County, Texas",2054,160,1626,146,400,86,124,69,276,83,28,29,0,18,28,29,0,18,0,18,0,18,0,18,0,18,0,18
0500000US48413,"Schleicher County, Texas",1114,95,746,77,364,61,24,19,340,62,4,7,0,13,4,7,0,13,0,13,0,13,0,13,0,13,0,13
0500000US48415,"Scurry County, Texas",6148,221,4259,220,1862,206,357,145,1505,237,18,28,0,20,18,28,6,13,0,20,6,13,3,7,0,20,3,7
0500000US48417,"Shackelford County, Texas",1354,74,1244,73,104,32,8,9,96,31,6,8,0,13,6,8,0,13,0,13,0,13,0,13,0,13,0,13
0500000US48419,"Shelby County, Texas",9768,255,8628,245,1054,137,356,118,698,141,39,43,0,24,39,43,24,32,0,24,24,32,23,34,0,24,23,34
0500000US48421,"Sherman County, Texas",996,67,679,62,316,60,94,28,222,51,1,2,0,13,1,2,0,13,0,13,0,13,0,13,0,13,0,13
0500000US48423,"Smith County, Texas",77916,870,66765,889,9296,403,2109,301,7187,452,1040,255,30,25,1010,251,676,133,115,66,561,141,139,88,39,41,100,76
0500000US48425,"Somervell County, Texas",3221,153,2737,147,474,74,143,111,331,120,10,17,0,18,10,17,0,18,0,18,0,18,0,18,0,18,0,18
0500000US48427,"Starr County, Texas",15671,413,356,117,15293,428,5436,398,9857,469,12,14,0,30,12,14,10,16,0,30,10,16,0,30,0,30,0,30
0500000US48429,"Stephens County, Texas",3552,227,3106,208,415,109,109,59,306,96,11,18,0,18,11,18,20,24,0,18,20,24,0,18,0,18,0,18
0500000US48431,"Sterling County, Texas",464,68,345,68,115,40,41,26,74,32,4,5,0,13,4,5,0,13,0,13,0,13,0,13,0,13,0,13
0500000US48433,"Stonewall County, Texas",615,75,545,86,49,33,3,4,46,31,18,25,0,13,18,25,0,13,0,13,0,13,3,4,0,13,3,4
0500000US48435,"Sutton County, Texas",1328,139,606,111,719,104,170,71,549,100,3,5,0,13,3,5,0,13,0,13,0,13,0,13,0,13,0,13
0500000US48437,"Swisher County, Texas",2622,162,1852,137,733,107,112,54,621,105,24,25,9,13,15,21,13,22,0,18,13,22,0,18,0,18,0,18
0500000US48439,"Tarrant County, Texas",651877,2648,479150,2641,125704,1708,33342,1253,92362,1907,18056,981,2301,458,15755,896,20526,756,5736,442,14790,777,8441,683,1513,321,6928,674
0500000US48441,"Taylor County, Texas",49423,694,40769,736,7112,426,1141,192,5971,469,818,206,70,49,748,204,529,114,206,72,323,97,195,94,76,52,119,76
0500000US48443,"Terrell County, Texas",439,76,178,51,254,67,35,26,219,63,7,9,0,13,7,9,0,13,0,13,0,13,0,13,0,13,0,13
0500000US48445,"Terry County, Texas",4096,188,2313,192,1621,171,334,104,1287,176,155,81,107,66,48,39,0,20,0,20,0,20,7,12,0,20,7,12
0500000US48447,"Throckmorton County, Texas",758,76,710,74,42,22,24,19,18,13,3,4,0,13,3,4,0,13,0,13,0,13,3,4,0,13,3,4
0500000US48449,"Titus County, Texas",10631,245,7572,204,2900,184,966,167,1934,199,92,47,20,23,72,46,64,25,5,9,59,27,3,5,0,27,3,5
0500000US48451,"Tom Green County, Texas",41796,628,30059,665,10705,436,1630,241,9075,484,602,176,105,111,497,136,366,117,115,86,251,120,64,45,0,30,64,45
0500000US48453,"Travis County, Texas",405406,1823,279739,1969,91945,1431,24613,968,67332,1606,14906,945,1388,316,13518,887,16167,714,3809,362,12358,687,2649,374,422,185,2227,341
0500000US48455,"Trinity County, Texas",4707,281,4459,250,216,68,31,18,185,64,3,6,0,20,3,6,29,31,6,9,23,29,0,20,0,20,0,20
0500000US48457,"Tyler County, Texas",8179,303,7630,313,414,168,101,116,313,116,98,59,0,24,98,59,34,47,0,24,34,47,3,5,0,24,3,5
0500000US48459,"Upshur County, Texas",14643,307,13714,287,643,126,130,70,513,112,161,77,0,27,161,77,71,51,0,27,71,51,54,61,0,27,54,61
0500000US48461,"Upton County, Texas",1179,77,702,69,477,62,100,36,377,54,0,13,0,13,0,13,0,13,0,13,0,13,0,13,0,13,0,13
0500000US48463,"Uvalde County, Texas",8660,291,3582,271,4993,244,745,171,4248,275,57,45,0,24,57,45,28,35,0,24,28,35,0,24,0,24,0,24
0500000US48465,"Val Verde County, Texas",14903,418,3633,228,11103,409,2454,317,8649,377,44,44,0,27,44,44,117,76,0,27,117,76,6,13,6,13,0,27
0500000US48467,"Van Zandt County, Texas",19330,394,17842,399,1290,128,256,87,1034,143,110,56,0,30,110,56,44,28,0,30,44,28,44,42,0,30,44,42
0500000US48469,"Victoria County, Texas",31927,491,22206,479,8780,480,1104,227,7676,454,516,150,40,31,476,148,271,96,122,68,149,94,154,98,0,30,154,98
0500000US48471,"Walker County, Texas",20151,1261,18198,1168,1496,255,415,148,1081,238,224,100,18,31,206,93,159,108,23,35,136,110,74,64,11,17,63,58
0500000US48473,"Waller County, Texas",13492,410,10649,406,2566,192,648,176,1918,210,194,85,32,45,162,71,54,48,0,27,54,48,29,33,0,27,29,33
0500000US48475,"Ward County, Texas",3934,163,2336,163,1560,140,282,95,1278,150,18,19,0,20,18,19,13,24,0,20,13,24,7,11,0,20,7,11
0500000US48477,"Washington County, Texas",12279,416,10667,412,1197,230,238,119,959,199,348,131,48,38,300,122,67,42,12,18,55,42,0,27,0,27,0,27
0500000US48479,"Webb County, Texas",67003,683,3034,336,63421,726,24298,812,39123,903,135,71,0,30,135,71,399,98,67,57,332,102,14,16,0,30,14,16
0500000US48481,"Wharton County, Texas",14638,346,10559,385,3732,294,842,201,2890,265,291,88,23,22,268,92,25,31,16,26,9,16,31,48,31,48,0,27
0500000US48483,"Wheeler County, Texas",2354,106,1942,119,342,64,128,41,214,63,27,28,0,18,27,28,41,28,0,18,41,28,2,3,0,18,2,3
0500000US48485,"Wichita County, Texas",48135,666,42204,664,4411,293,914,203,3497,308,538,135,89,70,449,120,887,148,208,102,679,136,95,62,0,30,95,62
0500000US48487,"Wilbarger County, Texas",5125,246,4403,243,667,117,177,90,490,96,42,32,0,20,42,32,13,16,10,16,3,5,0,20,0,20,0,20
0500000US48489,"Willacy County, Texas",5382,254,2572,259,2781,285,779,178,2002,261,16,18,0,24,16,18,0,24,0,24,0,24,13,18,0,24,13,18
0500000US48491,"Williamson County, Texas",151352,1091,116759,1478,23596,891,3353,505,20243,872,5738,549,376,121,5362,542,4444,377,808,219,3636,385,815,231,78,62,737,216
0500000US48493,"Wilson County, Texas",15122,269,10478,331,4276,288,422,136,3854,290,287,92,43,33,244,84,66,65,0,27,66,65,15,17,7,11,8,14
0500000US48495,"Winkler County, Texas",2672,119,1443,120,1217,106,337,117,880,124,5,9,0,18,5,9,7,11,0,18,7,11,0,18,0,18,0,18
0500000US48497,"Wise County, Texas",20352,376,17635,380,2450,227,443,162,2007,235,178,76,21,26,157,64,60,31,0,30,60,31,29,26,0,30,29,26
0500000US48499,"Wood County, Texas",15904,453,14970,438,807,147,134,68,673,150,84,42,0,27,84,42,37,22,17,9,20,22,6,10,0,27,6,10
0500000US48501,"Yoakum County, Texas",2610,114,1371,131,1179,143,537,170,642,153,52,33,20,23,32,26,8,8,0,18,8,8,0,18,0,18,0,18
0500000US48503,"Young County, Texas",7209,270,6365,248,801,110,311,117,490,127,30,31,0,20,30,31,4,9,4,9,0,20,9,15,0,20,9,15
0500000US48505,"Zapata County, Texas",4357,304,366,61,3991,301,1318,263,2673,313,0,20,0,20,0,20,0,20,0,20,0,20,0,20,0,20,0,20
0500000US48507,"Zavala County, Texas",3557,197,599,136,2958,202,1001,163,1957,197,0,20,0,20,0,20,0,20,0,20,0,20,0,20,0,20,0,20